JAP: 일본
 - 인게임에 영향 무
RUS: 러시아
 - 인게임에 영향 무
CHN: 중국
 - 인게임에 영향 무
KOR: 한국 (대한민국)
 - 인게임에 영향 무
WPK: 북한 (조선민주주의인민공화국)
 - 인게임에 영향 무
DMP: 더불어민주당
 - 이재명 나오나?
PPP: 국민의힘
 - 얘넨 작동 안함
ROK: 대한민국
 - 멸망한 국기임.
YG1: 홍통특별행정구
 - 전라인민공화국의 괴뢰국, 모든 전라인민공화국의 기업들은 홍통특별행정구의 여수증권거래소에 상장되어야만 해외 투자를 받을 수 있음, 시장경제 및 자본주의 체제를 도입함. 광양 - 여수간 육로가 막혀있어서 다리로만 직접적인 이동이 가능함.
 - 추가적으로, 홍통특별행정구는 외국인 투자자에게 세금 감면 혜택을 제공하여 경제 성장을 촉진하고 있음.
JNR: 전라인민공화국
 - 광주특별시를 수도로하는 사회주의 공화국임. 
 - 이 나라는 강력한 중앙집권적 정부를 가지고 있으며, 모든 산업은 국가 소유임.
CHU: 충주 공화국
 - 나도 모름
SAG: 사가현
 - 나도 모름
KGR: 남해 국가판무관부
 - 지옥에 있는 되니츠가 남해 독일마을을 기점으로 건국하여 남해 전역을 점유한 국가임. 남해 독일마을은 현재 남해 국가판무관부의 수도임. 독일의 영토를 되찾기 위한 발판으로 코리아셰 국가판무관부 수립을 목표로 한반도 점령을 기획함.
   어 뭐라고 써야할지 모르겠음.
CWD: 윤석열 친위대
 - 나도 모름
HMC: 포항 해병성채
 - 포항 해병대 사령부
AIR: 공군 사령부
 - 진주 공군 사령부
IRK: Tuile Mhóir Deirge
 - 대홍단에 위치함, 강원도의 감자공국에서 통용되는 화폐를 위조하는 범죄자들의 소굴.
KRU: 고려대학교
 - 가고싶다.
CAT: 한국고양이보호협회
 - 삭제
YBJ: 검찰공화국
 - 구 대한민국의 대통령이 세운 국가다. 
GWA: 신성 광주정신 숭고국
 - 경기도 광주시에 위치한 국가, 강기정이 광주광역시로 복귀하는 순간 쿠데타 발생. 성남을 탈환할 계획을 세움.
GYE: 계룡대 사이버 사령부
 - 이거 좀 내용 긴데 뭐라고 써야할지 모르겠음.
NON: 논산군트 징집단국
 - 논산 군트 징집단국, 논산 군트 징집단국 사령부는 논산 군트 징집단국 사령부 소재지에 위치함.
SIN: 신안 제국
 - 노예제 국가임. 슨상령과 사이가 이상하게 좋음.
PWS: 킁킁 생불령
 - 박원순이 사망한 북악산에 위치할 생불령이다 할 수 있지
SEO: 씨발시티 시청
 - 박원순 그립다
 - 박원순 그립다
 - 박원순 그립다
CCS: 동두천 바이킹
 - 이새끼 삭제하고 동두천에 넣을거 추천좀
HNU: 한우국
NLU: 경기동부연합
LAB: 무장단체 RO
 - 통진당 수괴 이석기가 주체혁명위업달성을 위한 무장단체 RO를 창설함.
AHN: 안철수 연구소
SMS: 삼성 그룹
 - 아아 그이름도 그리운 이재용 
DCE: 대한두체협회
SSD: 성심당
BSU: 브라더후드 오브 스틸
SAD: 전국장애인차별철폐연대
ILB: 일베시티
JNH: 호남향우회
 - 얘넨 그거다.
ITW: 이태원 칼리프국
VII: 윤의철의 7군단
LEG: 레고랜드
DAS: 다스 PMC 그룹
 - 이명박이 어쩌고 저쩌고
TAE: 통궈랜드
 - 홍준표 각하를 수반으로하는 대구광역시의 국가.
   게임 시작부터 진보당 반란 세력으로부터 대구광역시를 지키는 중.
   시작부터 군위를 보호령으로 종속화해서 중점타다보면 합병됨.
   대신 군위 점령하면 공항을 군위로 뺴야하고, 군위 불만 없게 좀 건드려줘야함.
ROH: 봉하마을
MJI: 평산책방
CAS: 강원랜드
PJH: 더이상(고)박정희각하를모욕하지말자
CRM: 청송교도소
SCH: 삼청교육대
GNG: 코바나컨텐츠
YGD: 량강도농민련합
ANS: 안산드레아스 카르텔
DON: 동대문상인연합회
SCJ: 신천지
UNF: 통일교
ILS: 일산그라드
ICH: 마계
YDG: 영아일랜드
DNT: 퐁퐁시티
NKA: 조국통일전선
SKA: 대한군정청
JMS: 신성복음연합
LJM: 국제마피아파
OIL: 태안에미리트 왕국
LEA: 수도군단
LEI: 1군단
III: 3군단
LEV: 5군단
LVI: 6군단
CLW: 태봉국
HAL: 할카스월드
YNG: 에버랜드
KAE: 개성공단
INA: 창공의 형제단
BUD: 조계종
ASS: 국K-1
YLS: 겨울왕국
BMB: 법무부
KJI: 메카-김정일 연구소
SPO: 대검찰청
LOT: 롯데 그룹
BRO: 형제복지원
NUC: 오대산 핵사일로
NYO: 녕변 핵사일로
GMP: 김포 해병대
HMR: 해병대전우회
OKC: 옥천 허브
BUS: 스까국
HNW: 하나원
TTT: 대한민국어버이연합
JEJ: 제주 해병대
YAN: 양양 나이트 클럽
GNW: 군위
ZZZ: 무정부
GGR: 구리 고구려 계승국
PJH_parkism: 국가재건최고회의
GAN: 강원도인 형제단
KRI: 미합중국 원주민 보호구역
SBU: 서부산인민혁명위원회
KDH: 우미관
UKK: 대영제국 왕실령 포트 해밀턴
RPL: 네오 창원
 - 창원 창원 창원
SNC: 순상그라드
 - 전인공 붕괴가 기정사실화 됐을경우에 이새끼들 분탕칠건데, 원래 전남동부는 정치력이 약한쪽이라 얘네가 첨부터 깽판은 못칠거고, 서부에서 갈라질 조짐이 나와야 이새끼도 깽판칠 수 있음.
RGG: 류경기경기국
 - 얘 뭐더라?
IBE: 베충이
 - 베트남 베충이 뭐라고 써야할지 모르겠음.
BUY: 부여 계승국
TNK: 탱크를 들고 일어난 하나회
 - 전두환 각하를 보위하기 위한 틀딱 단체인데
   극우라서 오래 못 집권 할거임
   실제로 플레이 하지 말라는 의미로 디버프 존나쎄게 달아놨음
   아무튼 하지마라
YED: 호서혁명위원회
GIR: 걸스캔두애니띵
SZC: 중화인민공화국 쓰촨정부
PYO: 제일 고귀한 평양 자본주의 귀족 공화국
US1: 미 공군 폭격 연습장
 - 플레이 불가능 국가, 원산은 원산폭격이 유명하니까 폭격의 신 르메이께서 이곳을 선택하셨다.
US2: 주한 미8군 한국군지원단
 - 평택중 미8군 한국군지원단 캠프가 위치한곳을 영토로함.
 - 얘네 존나쌤
 - 바이든이 쫄튀하며 자연스레 철수
 - 플레이할 유저는 없겠지만 목표 설정을 어케해야할지 모르겠네.
PTT: 신성감자제국
 - 병신새끼
OKS: 옥수수 제후국
GI2: 영남 해방구
 - 삭제 예정